[console_scripts]
pycmd2=pycmd2.cli:cli.app
ggrep=pycmd2.demos.grep:cli.app
envjs=pycmd2.commands.dev.env_javascript:cli.app
envpy=pycmd2.commands.dev.env_python:cli.app
envrs=pycmd2.commands.dev.env_rust:cli.app
gitadd=pycmd2.commands.dev.git_add:cli.app
gitc=pycmd2.commands.dev.git_clean:cli.app
gitinit=pycmd2.commands.dev.git_init:cli.app
gitpa=pycmd2.commands.dev.git_push_all:cli.app
gitre=pycmd2.commands.dev.git_restart_tgitcache:cli.app
mkp=pycmd2.commands.dev.make_python:cli.app
pipd=pycmd2.commands.dev.pip_download:cli.app
pipdr=pycmd2.commands.dev.pip_download_req:cli.app
pipf=pycmd2.commands.dev.pip_freeze:cli.app
pipi=pycmd2.commands.dev.pip_install:cli.app
pipio=pycmd2.commands.dev.pip_install_offline:cli.app
pipir=pycmd2.commands.dev.pip_install_req:cli.app
pipr=pycmd2.commands.dev.pip_reinstall:cli.app
pipu=pycmd2.commands.dev.pip_uninstall:cli.app
pipur=pycmd2.commands.dev.pip_uninstall_req:cli.app
ssh-copy-id=pycmd2.commands.dev.ssh_copy_id:cli.app
docdiff=pycmd2.commands.office.doc_diff:cli.app
img2pdf=pycmd2.commands.office.image_to_pdf:cli.app
imggry=pycmd2.commands.office.image_gray:cli.app
llmcli=pycmd2.commands.office.llama_client:main
llmqnt=pycmd2.commands.office.llama_quantize:main
llmsvr=pycmd2.commands.office.llama_server:main
mindnote=pycmd2.commands.office.mindnote.cli:main
pdfc=pycmd2.commands.office.pdf_crypt:cli.app
pdfmrg=pycmd2.commands.office.pdf_merge:cli.app
pdfspl=pycmd2.commands.office.pdf_split:cli.app
pdft=pycmd2.commands.office.pdftools.cli:main
pdftw=pycmd2.commands.office.pdftoolweb.cli:main
todo=pycmd2.commands.office.todo.cli:main
videoconv=pycmd2.commands.office.video_converter:main
alarmclk=pycmd2.commands.system.alarmclock.cli:main
checksum=pycmd2.commands.system.checksum.checksum:main
filedate=pycmd2.commands.system.file_date:cli.app
filelvl=pycmd2.commands.system.file_level:cli.app
folderb=pycmd2.commands.system.folder_backup:cli.app
folderz=pycmd2.commands.system.folder_zip:cli.app
ld=pycmd2.commands.system.list_dirs:cli.app
taskk=pycmd2.commands.system.task_kill:cli.app
wch=pycmd2.commands.system.which:cli.app
lscopt=pycmd2.web.simulation.lscopt.lscopt_gui:main
websvr=pycmd2.web.server:main
